............................................................................................................................
............................................................................................................................
............................................................................................................................
............................................................................................................................
..........................█████.............................................................................................
..........█████...........█████.....................................████████████████████████████████████████████████████████
████████████████████████████████████████████████████████████████████████████████████████████████████████████████████████████
████████████████████████████████████████████████████████████████████████████████████████████████████████████████████████████